Russian=ru
English=en
German=de
Azerbaijanian=az
Albanian=sq
Amharic=am
Arabic=ar
Armenian=hy
Afrikaans=af
Basque=eu
Bashkir=ba
Belorussian=be
Bengali=bn
Bulgarian=bg
Bosnian=bs
Belsh=cy
Hungarian=hu
Vietnamese=vi
Haitian=ht
Galician=gl
Dutch=nl
Mining=mrj
Greek=el
Georgian=ka
Gujarati=gu
Danish=da
Hebrew=he
Yiddish=yi
Indonesian=id
Irish=ga
Italian=it
Icelandic=is
Spanish=es
Kazakh=kk
Kannada=kn
Catalan=ca
Kyrgyz=ky
Chinese=zh
Korean=ko
Braid= xh
Latin=la
Latvian=lv
Lithuanian=lt
Luxembourgish=lb
Malagasy=mg
Malay=ms
Malayalam=ml
Maltese=mt
Macedonian=mk
Maori=mi
Marathi=mr
Mari=mhr
Mongolian=mn
Nepali=ne
Norwegian=no
Punjabi=pa
Papiamento=pap
Persian=fa
Polish=pl
Portuguese=pt
Romanian=ro
Cebuian=ceb
Serbian=sr
Sinhala=si
Slovak=sk
Slovenian=sl
Swahili=sw
Sundanese=su
Tajik=tg
Thai=th
Tagalog=tl
Tamil=ta
Tatar=tt
Telugu=te
Turkish=tr
Udmurt=udm
Uzbek=uz
Ukrainian=uk
Urdu=ur
Finnish=fi
French=fr
Hindi=hi
Croatian=hr
Czech=cs
Swedish=sv
Scottish=gd
Estonian=et
Esperanto=eo
Javanese=jv
Japanese=ja